10 10
0 -1 0 -1 0 -1 0 -1 0 -1
5 5 5 5 5 5 5 5 5 5
-1 0 -1 0 -1 0 -1 0 -1 0
4 4 4 4 4 4 4 4 4 4
0 -1 0 -1 0 -1 0 -1 0 -1
3 3 3 3 3 3 3 3 3 3
-1 0 -1 0 -1 0 -1 0 -1 0
2 2 2 2 2 2 2 2 2 2
0 -1 0 -1 0 -1 0 -1 0 -1
1 1 1 1 1 1 1 1 1 1